XXXXXXXXXXXXXXXXXXXXXXXXXXXXXXXXXXXXXXXXXXXXXXXXXXXXXXXXXXXXXXXXXXXXXXXXXXXXXXXXX
XSX       X             X       X     X   X X   X X       X   X         X       X
X X X X XXX X XXXXX X XXX X XXX XXXXX X X X X X X X XXX XXX XXX XXXXXXX X XXX XXX
X X X X X   X     X X X   X X X   X     X   X X X X X X     X   X         X     X
X XXX X XXXXXXXXX XXXXXXX XXX X XXXXX XXXXX X XXX X X XXXXX XXX XXXXX X XXXXXXX X
X X X X       X       X   X               X       X X   X X       X   X X   X   X
X X XXX XXXXXXXXXXX XXX X XXXXX XXXXXXX XXXXX XXX X X XXX X X XXXXXXXXX X X X XXX
X         X X   X X     X X   X X   X   X   X X X X X X X X X X X   X   X X     X
X X X X X X X X X XXX X X XXX X X X XXXXX X X X X X X X X XXXXX X XXX XXX X XXXXX
X X X X X     X X     X X X X     X     X X     X   X   X         X     X X X X X
XXX X X XXX X XXXXXXXXXXX X XXXXXXXXXXXXXXX XXXXX X X XXXXX XXXXX XXXXX XXXXX X X
X   X X   X X X X   X X         X               X X X     X     X   X X         X
X X XXXXXXXXXXX X X X X XXXXXXXXXXXXXXXXX XXXXXXXXXXX XXXXX X XXXXX X XXX XXXXX X
X X X   X   X X   X   X       X X X       X           X X   X X         X   X X X
X XXXXX X XXX X X XXXXX XXX XXX X XXXXXXX XXX XXXXXXX X X XXXXXXX XXXXX X X X XXX
X X   X   X     X     X   X X     X               X   X   X     X X X     X X X X
X X XXX X X XXX XXXXXXX XXXXX XXX XXX XXXXX XXX XXXXXXXXXXX XXXXXXX X X XXXXX X X
X X X X X X X X     X     X   X       X   X X   X X         X       X X X       X
X X X XXX X X XXXXX X XXX X XXX XXXXXXXXX XXX X X X XXX X XXXXX XXX X XXX X X XXX
X                 X   X   X X       X         X       X X   X     X       X X  FX
XXXXXXXXXXXXXXXXXXXXXXXXXXXXXXXXXXXXXXXXXXXXXXXXXXXXXXXXXXXXXXXXXXXXXXXXXXXXXXXXX