XXXXXXXXXXXXXXXXXXXXXXXXXXXXXXXXXXXXXXXXXX
XSXX   XXXXX            XXXXX   XX       X
X X  X  XXXX XX X X X X   X   X X  X XXX X
X   XXX  XX  XX     X   X   XXX   X  XX  X
XXXXXXXX XX XXXXXX XX X  XXXXXXXXX  XX  XX
XXXXXXXX  X XXXXXX    XX   XXXXXXX XXX XXX
XXXXXXXXX X XXXXXXXXXXXXXX      XX     XXX
XXXXXXXXX   XXXXXXXXXXXXXXXXXXX XXXXXXXXXX
XXXXXXXXXXXXXXXXXXXXXXXXXXXXXXX XXXXXXXXXX
XXXXXXXXXXXXXXXXXXXXXXXXX   XXX XXXXXXXXXX
XXXXXXXXXXXXXXXXXXXXXXXXX X     XXXXXXXXXX
XXXXXXXXXXXXXXXXXXXXXXX   XXXXXXXXXXXXXXXX
XXXXXXXXXXXXXXXXXXXXXXX XXXXX     XXXXXXXX
XXXXXXXXXXXXXXXXXXXXXXX  XXX  XXX     XXXX
XXXXXXXXXXXXXXXXXXXXXXXX XXX XXXXXXXX   XX
XXXXXXXXXXXXXXXXXXXXXXXX XX  XXXXXXXX X XX
XXXXXXXXXXXXXXXXXXXXXXXX    XXXXXXXXX X XX
XXXXXXXXXXXXXXXXXXXXXXXXXXXXXXXXXXXXX    X
XXXXXXXXXXXXXXXXXXXXXXXXXXXXXXXXXXXXX XX X
XXXXXXXXXXXXXXXXXXXXXXXXXXXXXXXXXXXXX  X X
XXXXXXXXXXXXXXXXXXXXXXXXXXXXXXXXXXXXXX  FX
XXXXXXXXXXXXXXXXXXXXXXXXXXXXXXXXXXXXXXXXXX